8
8
1 1 2 1 2 2 1 3
1 2 3 1 3 3 2 1
1 2 1 3 3 1 3 1
3 1 2 3 3 1 2 1
1 2 3 1 3 4 3 2
1 1 4 1 0 1 3 1
3 2 4 3 4 1 1 1
2 1 1 2 1 1 2 1